niveau 1
taille 6 5
joueur (2;2)
temps 60
terrain
f   f   f   f   f   f
f   >t  >t  vt  f   f
f   ^t  f   vS> >t  s
f   ^t  vTol vt <t  f
f   ^t  <t  <t  f   f
objectifs (TOLE;2)
gevents 1
generator METAL spawntime=5 offset=0
entrees (4;3)
fin niveau


niveau 2
taille 10 10
joueur (5;5)
temps 70
terrain
f f >t >t >t >t >t >t vt f
f f ^t f f ^Tol f f vt f
f f ^t f f f f f vt f
f f ^t f f f f f vt f
>t >t ^t f f f f f vt f
s  <t ^S< f f f f f vt f
f f ^t f f f f f vt f
f f ^t f f f f f vt f
f f ^t f f vSci f f vt f
f f ^t <t <t <t <t <t <t f
objectifs (PLANCHE;1) (TOLE;2)
gevents 1
generator METAL spawntime=6 offset=0
entrees (0;4)
generator BOIS spawntime=6 offset=3
entrees (0;4)
fin niveau



niveau 3
taille 12 14
joueur (3;5)
temps 90
terrain
f   f   f   f   f   f   f   f   f   s   f   f
>t  >t  >t  >t  >t  vt  >t  >t  >t  >S^ >t  vt
^t  f   f   f   f   vt  ^t  f   f   f   f   vt
^t  f   f   f   f   vt  ^t  f   f   f   f   vt
^t  f   f   f   f   vt  ^t  f   f   f   f   vt
^t  f   f   f   f   vt  ^t  f   f   f   f   vt
^t <Sci f   f   f   vP  ^P  f   f   f  >Bru vt
^t  f   f   f   f   vt  ^t  f   f   f   f   vt
^t  f   f   f   f   vt  ^t  f   f   f   f   vt
^t  f   f   f   f   vt  ^t  f   f   f   f   vt
^t  f   f   f   f   vt  ^t  f   f   f   f   vt
^t  <t  <Sv  <t <t  <t  ^t  <t  <t  <t <t   <t
f   f   s   f  ^t   f   f   ^t   f   f   f   f
f   f   f   f  ^t   f   f   ^t   f   f   f   f
objectifs (PLANCHE;2) (CHARBON;2)
gevents 1
generator BOIS spawntime=5 offset=0
entrees (4;13)
generator BOIS spawntime=5 offset=0
entrees (7;13)
fin niveau



niveau 4
taille 20 20
joueur (10;10)
temps 120
terrain
f   f   >T  >T  >T  >T  >T  >T  >T  >T  >T  >T  >T  >T  >T  >T  >T  >T  >T  vT
f   f   ^T  f   f   f   f   f   f   f   f   f   f   f   f   f   f   f   f   vT
f   f   ^T  f   f   f   f   f   f   f   f   f   f   f   f   f   f   f   f   vT
f   f   ^T  f   f   vt  <t  <t  <t  <t  <t  <t  <t  <t  <t  <t  <t  f   f   vT
f   f   ^T  f   f   vt  f   f   f   f   f   f   f   f   f   f   ^t  f   f   vT
f   f   ^T  f   f   vt  f   f   f   f   f   f   f   f   f   f   ^t  f   f   vT
f   f   ^T  f   f   vt  f   f   f   f   f   f   f   f   f   f   ^t  f   f   vT
f   f   ^T  f   f   vt  f   f   f   f   f   f   f   f   f   f   ^t  f   f   vT
f   f   ^T  f   f   vt  f   f   f   f   f   f   f   f   f   f   ^t  f   >Sci vT
>t >t   ^T  f   f   vS> >t  s   f   f   f   f   f   f   f   f   ^t  f   f   vT
s  <t  ^S<  f   f  vt  <t  <t  f   f   f   f   f   f   f   f   ^t  f   f   vT
f   f   ^T  f   f   vt  f   f   f   f   f   f   f   f   f   f   ^P  f   f   vT
f   f   ^T  f   f   vt  f   f   f   f   f   f   f   f   f   f   ^t  f   f   vT
f   f   ^T  f   f   vt  f   f   f   f   f   f   f   f   f   f   ^t  f   f   vT
f   f   ^T  f   f   vt  f   f   f   f   f   f   f   f   f   f   ^t  f   f   vT
f   f   ^T  f   f   vt  f   f   f   f   f   vSci f   f   f   f  ^t  f   f   vT
f   f   ^T  f   f   >t  >t  >t  >t  >t  >t  >t  >t  >t  >t  >t  ^t  f   f   vT
f   f   ^T  f   f   f   f   f   f   f   f   f   f   f   f   f   f   f   f   vT
f   f   ^T  f   f   f   f   f   f   f   f   f   f   f   f   f   f   f   f   vT
f   f  ^T  <T  <T  <T  <T  <T  <T  <T  <T  <T  <T  <T  <T  <T  <T  <T  <T   <T
objectifs (PLANCHE;5)
gevents 1
generator BOIS spawntime=3 offset=0
entrees (1;9)
generator BOIS spawntime=3 offset=0
entrees (7;10)
fin niveau






niveau 6
taille 13 14
joueur (4;6)
temps 120
terrain
f   f   f   f   f   f   f   f   f   f   f   f   f
f   f   f   f   f   s   vt  f   f   f   f   f   f
f   f   >t  >t  >t  >S^ >t  >t  >t  >t  vt  f   f
f   f   ^t  f   f   f   b   f   f   f   vP  f   f
f   f   ^t  <Cui f  f   b   f   f   f   vt  f   f
f   f   ^t  f   f   f   b   f   f   f   vt  f   f
f   f   ^t  f   f   f   b   f   f   f   vt  f   f
f   f   ^t  f   f   f   b   f   f   f   vt  f   f
f   f   ^t  f   f   f   b   f   f   f   vt  f   f
f   f   ^t  f   f   f   b   f   f   >Ton vt f   f
f   f   ^P  f   f   f   b   f   >f   f  vt  f   f  
f   f   ^t  <t  <t  <t  <t  <t  <t  <t  <t  f   f
f   f   f   f   f   f   f   f   f   f   f   f   f
f   f   f   f   f   f   f   f   f   f   f   f   f
objectifs (LAINE;4) (VIANDE;2)
gevents 1
generator MOUTON spawntime=4 offset=0
entrees (6;1)
fin niveau


niveau 5
taille 18 16
joueur (9;8)
temps 90
terrain
f	>t  >t  >t  >t  >t  >t  >t  >t  >t  >t  >t  >t  >t  >t  >t  vt  f
s	^S< >t  >t  >t  >t  >t  >t  >t  >t  >t  >t  >t  vt  f   f   vt  f
f	^t  ^S< >t  >t  >t  >t  >t  >t  >t  vt  f   f   vt  f   f   vt  f
f	^t  ^t  ^S< >t  >t  >t  vt  f   f   vP  f   >Bru vt f   f   vt  f
f	^t  ^t  ^t  ^S< f   f   vt  f   f   vt  f   f   vt  f   f   vt  f
f	^t  ^t  ^t  ^t  f   f   vt  f   f   vt  f   f   vt  f   f   vt  f
f	^t  ^t  ^t  ^t  f   >Tol vt f   f   vt  f   f   vt  f   f   vt  f
f	^t  ^t  ^t  ^t  f   f   vt  f   f   vt  f   f   vt  f   f   vt  f
f	^t  ^t  ^t  ^t  f   f   vt  f   f   vt  f   f   vt  f   f   vt  f
f	^t  ^t  ^t  ^TPout1  f   f   vt  f   f   vt  f   f   vt  f   f   vt  f
f	^t  ^t  ^t  ^t  f   f   vt  f   f   vt  f   f   vt  f   f   vt  f
f	^t  ^t  ^t  ^t  f   f   vP  f   >Tol vt f   f   vt  f   f   vt  f
f	^t  ^t  ^t  ^t  <t  <t  <t  f   f   vt  f   f   vt  f   f   vt  ^TPin1
f	^t  ^t  ^t  <t  <t  <t  <t  <t  <t  <t  f   f   vP  f   f   vt  ^t
f	^t  ^t  <t  <t  <t  <t  <t  <t  <t  <t  <t  <t  <t  f   >Fon vt ^t
f	^t  <t  <t  <t  <t  <t  <t  <t  <t  <t  <t  <t  <t  <t  <t  <t  f
objectifs (CHARBON;1) (PIERRE;1) (TOLE;1) (METAL_FUSION;1)
gevents 1
generator METAL spawntime=1 offset=0
entrees (1;8)
generator BOIS spawntime=2 offset=0
entrees (2;8)
generator SABLE spawntime=1 offset=0
entrees (3;8)
generator METAL spawntime=2 offset=0
entrees (4;8)
fin niveau


niveau 7
taille 9 16
joueur (3;8)
temps 115
terrain
f   f        f   f  f        f   f   f        f
f   vTPout3  f   f  vTPout1  f   f   vTPout2  f
f   vt       f   f   vt      f   f   vt       f
f   vt       f   f   vt      f   f   vt       f
f   vt       f   f   vt      f   f   vt       f
f   vt       f   f   vt      f   f   vt       f
f   vt       f   >Tol vt     f   f   vt       f
f   vt       f   f   vt      f   f   vt       f
f   vt       f   f   vt      f   f   vt       f
f   vt       f   f   vt      f   >Sci vt       f
f   vt       f   f   vt      f   f    vt       f
f   vt       f   f   vt      f   f   vS>     s
>Fon vt      f   f   vt      f   f   vt       f
f   vt       f   f   vt      f   f   vt       f
f   vTPin1   f   f   vTPin2  f   f   vTPin3   f
f   f        f   f   f       f   f   f        f
objectifs (RAIL;1)
gevents 1
generator METAL spawntime=3 offset=0
entrees (1;5)
generator BOIS spawntime=3 offset=0
entrees (7;5)
generator OR_BRUT spawntime=2 offset=0
entrees (7;5)
fin niveau


niveau 8
taille 15 11
joueur (4;3)
temps 100
terrain
f   >t  >t  >t  >t  >t  >t  >t  >t  >t  >t  >t  >t  >t  vt
f   ^t  b   b   b   b   b   f   f   f   f   f   f   f   vt
f   ^t  f   f   f   f   b   f   b   b   b   b   b   b   vt
f   ^t  <Tol f  f   f   b   f   b   f   f   f   f   f   vt
f   ^t  b   b   f   f   b   f   b   f   f   f   f   >Fon vt
>t  ^t  f   b   f   f   b   f   b   f   f   b   b   b vt
<t  ^S< f   b   f   f   b   b   b   f   f   b   f   f   vt
f   ^t  f   b   f   f   f   f   f   f   f   b   f   f   vt
f   ^t  f   b   f   f   f   f   f   f   f   b   f   f   vt
f   ^t  f   b   b   b   b   b   b   b   b   b   f   f   vt
f   ^t  <t  <t  <t  <t  <t  <t  <t  <t  <t  <t  <t  <t  <t
objectifs (COUTEAU;2)
gevents 1
generator METAL spawntime=2 offset=0
entrees (0;5)
generator PLASTIQUE spawntime=2 offset=1
entrees (0;5)
fin niveau


niveau 10
taille 76 56
joueur (28;20)
temps 100
terrain
f   f   f   f   f   f       f   f      f       f        f     f   f   f   f   f   f   f   f   f   f  f   f   f   f       f   f      f       f        f      f   f   f   f   f   f   f   f   f   f   f   f   f   f       f       f      f      f       f       f   f   f   f   f   f   f   f  f   f  f   f   f   f       f   f      f       f        f        f   f   f   f   f   f   f   f
f   f   f   f   f   >TPin2  f   f      vTPout1 f        f     f   f   f   f   f   f   f   f   f   f  f   f   f   >TPin3  f   f      vTPout2 f        f      f   f   f   f   f   f   f   f   f   f   f   f   f   >TPin12 f       f    vTPout11 f       f       f   f   f   f   f   f   f   f  f   f  f   f   f   >TPin13  f   f    vTPout12 f        f        f   f   f   f   f   f   f   f
f   f   >t  >t  >t  >S^    >t   >t     >t     >t       vt     f   f   f   f   f   f   f   f   f   f  >t  >t  >t  >S^    >t   >t     >t     >t       vt      f   f   f   f   f   f   f   f   f   f   >t  >t  >t  >S^    >t       >t    >t     >t       vt      f   f   f   f   f   f   f   f  f   f  >t  >t  >t  >S^    >t   >t     >t     >t       vt        f   f   f   f   f   f   f   f
f   f   ^t  f   f   f       b   f       f      f       vP     f   f   f   f   f   f   f   f   f   f  ^t  f   f   f       b   f       f      f       vP      f   f   f   f   f   f   f   f   f   f   ^t  f   f   f       b       f      f      f       vP      f   f   f   f   f   f   f   f  f   f  ^t  f   f   f       b   f       f      f       vP        f   f   f   f   f   f   f   f
f   f   ^t  <Cui f  f       b   f       f      f       vt     f   f   f   f   f   f   f   f   f   f  ^t  <Cui f  f       b   f       f      f       vt      f   f   f   f   f   f   f   f   f   f   ^t  <Cui f  f       b       f      f      f       vt      f   f   f   f   f   f   f   f  f   f  ^t  <Cui f  f       b   f       f      f       vt        f   f   f   f   f   f   f   f
f   f   ^t  f   f   f       b   f       f      f       vt     f   f   f   f   f   f   f   f   f   f  ^t  f   f   f       b   f       f      f       vt      f   f   f   f   f   f   f   f   f   f   ^t  f   f   f       b       f      f      f       vt      f   f   f   f   f   f   f   f  f   f  ^t  f   f   f       b   f       f      f       vt        f   f   f   f   f   f   f   f
f   f   ^t  f   f   f       b   f       f      f       vt     f   f   f   f   f   f   f   f   f   f  ^t  f   f   f       b   f       f      f       vt      f   f   f   f   f   f   f   f   f   f   ^t  f   f   f       b       f      f      f       vt      f   f   f   f   f   f   f   f  f   f  ^t  f   f   f       b   f       f      f       vt        f   f   f   f   f   f   f   f
f   f   ^t  f   f   f       b   f       f      f       vt     f   f   f   f   f   f   f   f   f   f  ^t  f   f   f       b   f       f      f       vt      f   f   f   f   f   f   f   f   f   f   ^t  f   f   f       b       f      f      f       vt      f   f   f   f   f   f   f   f  f   f  ^t  f   f   f       b   f       f      f       vt        f   f   f   f   f   f   f   f
f   f   ^t  f   f   f       b   f       f      f       vt     f   f   f   f   f   f   f   f   f   f  ^t  f   f   f       b   f       f      f       vt      f   f   f   f   f   f   f   f   f   f   ^t  f   f   f       b       f      f      f       vt      f   f   f   f   f   f   f   f  f   f  ^t  f   f   f       b   f       f      f       vt        f   f   f   f   f   f   f   f
f   f   ^t  f   f   f       b   f       f      >Ton     vt    f   f   f   f   f   f   f   f   f   f  ^t  f   f   f       b   f       f      >Ton     vt     f   f   f   f   f   f   f   f   f   f   ^t  f   f   f       b       f      f      >Ton     vt     f   f   f   f   f   f   f   f  f   f  ^t  f   f   f       b   f       f      >Ton     vt       f   f   f   f   f   f   f   f
f   f   ^P  f   f   f       b   f       >f      f      vt     f   f   f   f   f   f   f   f   f   f  ^P  f   f   f       b   f       >f      f      vt      f   f   f   f   f   f   f   f   f   f   ^P  f   f   f       b       f      >f      f      vt      f   f   f   f   f   f   f   f  f   f  ^P  f   f   f       b   f       >f      f      vt        f   f   f   f   f   f   f   f
f   f   ^t  <t  <t  <t      <t  <t      <t     <t      <t     f   f   f   f   f   f   f   f   f   f  ^t  <t  <t  <t      <t  <t      <t     <t      <t      f   f   f   f   f   f   f   f   f   f   ^t  <t  <t  <t      <t      <t     <t     <t      <t      f   f   f   f   f   f   f   f  f   f  ^t  <t  <t  <t      <t  <t      <t     <t      <t        f   f   f   f   f   f   f   f
f   f   f   f   f   f       ^t  f       f      f       f      f   f   f   f   f   f   f   f   f   f  f   f   f   f       ^t  f       f      f       f       f   f   f   f   f   f   f   f   f   f   f   f   f   f       ^t      f      f      f       f       f   f   f   f   f   f   f   f  f   f  f   f   f   f       ^t  f       f      f       f         f   f   f   f   f   f   f   f
f   f   f   f   f   f       f   f       f      f       f      f   f   f   f   f   f   f   f   f   f  f   f   f   f       f   f       f      f       f       f   f   f   f   f   f   f   f   f   f   f   f   f   f       f       f      f      f       f       f   f   f   f   f   f   f   f  f   f  f   f   f   f       f   f       f      f       f         f   f   f   f   f   f   f   f
f   f   f   f   f   f       f   f       f      f       f      f   f   f   f   f   f   f   f   f   f  f   f   f   f       f   f       f      f       f       f   f   f   f   f   f   f   f   f   f   f   f   f   f       f       f      f      f       f       f   f   f   f   f   f   f   f  f   f  f   f   f   f       f   f       f      f       f         f   f   f   f   f   f   f   f
f   f   f   f   f   f       f   f       f      ^TPin1 vTPout7 f   f   f   f   f   f   f   f   f   f  f   f   f   f       f   f       f   ^TPin4     vTPout3 f   f   f   f   f   f   f   f   f   f   f   f   f   f       f       f      f     ^TPin11 vTPout17 f   f   f   f   f   f   f   f  f   f  f   f   f   f   f   f    f    ^TPin14 vTPout13 f         f   f   f   f   f   f   f   f
f   f   f   f   f   f       >t  >t      >t     >S^    >t     >t  >t  >t  vt   f   f   f   f   f   f  f   f   f   f       >t  >t      >t   >S^        >t     >t  >t  >t  vt  f   f   f   f   f   f   f   f   f   f       >t      >t     >t     >S^    >t      >t  >t  >t  vt   f   f   f   f  f   f  f   f   f   f   >t  >t   >t   >S^      >t     >t         >t  >t  vt  f   f   f   f   f
f   f   f   f   f   f       ^t  f       f      f       b      f   f   f   vP  f   f   f   f   f   f  f   f   f   f       ^t  f       f       f       b      f   f   f   vP  f   f   f   f   f   f   f   f   f   f       ^t      f      f       f      b       f   f   f   vP  f   f   f   f  f   f  f   f   f   f   ^t  f    f     f       b      f          f   f   vP  f   f   f   f   f
f   f   f   f   f   f       ^t  <Cui    f      f       b      f   f   f   vt  f   f   f   f   f   f  f   f   f   f       ^t  <Cui    f       f       b      f   f   f   vt  f   f   f   f   f   f   f   f   f   f       ^t      <Cui   f       f      b       f   f   f   vt  f   f   f   f  f   f  f   f   f   f   ^t  <Cui f     f       b      f          f   f   vt  f   f   f   f   f
f   f   f   f   f   f       ^t  f       f      f       b      f   f   f   vt  f   f   f   f   f   f  f   f   f   f       ^t  f       f       f       b      f   f   f   vt  f   f   f   f   f   f   f   f   f   f       ^t      f      f       f      b       f   f   f   vt  f   f   f   f  f   f  f   f   f   f   ^t  f    f     f       b      f          f   f   vt  f   f   f   f   f
f   f   f   f   f   f       ^t  f       f      f       b      f   f   f   vt  f   f   f   f   f   f  f   f   f   f       ^t  f       f       f       b      f   f   f   vt  f   f   f   f   f   f   f   f   f   f       ^t      f      f       f      b       f   f   f   vt  f   f   f   f  f   f  f   f   f   f   ^t  f    f     f       b      f          f   f   vt  f   f   f   f   f
f   f   f   f   f   f       ^t  f       f      f       b      f   f   f   vt  f   f   f   f   f   f  f   f   f   f       ^t  f       f       f       b      f   f   f   vt  f   f   f   f   f   f   f   f   f   f       ^t      f      f       f      b       f   f   f   vt  f   f   f   f  f   f  f   f   f   f   ^t  f    f     f       b      f          f   f   vt  f   f   f   f   f
f   f   f   f   f   f       ^t  f       f      f       b      f   f   f   vt  f   f   f   f   f   f  f   f   f   f       ^t  f       f       f       b      f   f   f   vt  f   f   f   f   f   f   f   f   f   f       ^t      f      f       f      b       f   f   f   vt  f   f   f   f  f   f  f   f   f   f   ^t  f    f     f       b      f          f   f   vt  f   f   f   f   f
f   f   f   f   f   f       ^t  f       f      f       b      f   f   >Ton vt f   f   f   f   f   f  f   f   f   f       ^t  f       f       f       b      f   f   >Ton vt f   f   f   f   f   f   f   f   f   f       ^t      f      f       f      b       f   f   >Ton vt f   f   f   f  f   f  f   f   f   f   ^t  f    f     f       b      f          f   >Ton vt f   f   f   f   f
f   f   f   f   f   f       ^P  f       f      f       b      f   >f   f  vt  f   f   f   f   f   f  f   f   f   f       ^P  f       f       f       b      f   >f   f  vt  f   f   f   f   f   f   f   f   f   f       ^P      f      f       f      b       f   >f   f  vt  f   f   f   f  f   f  f   f   f   f   ^P  f    f     f       b      f          >f   f  vt  f   f   f   f   f
f   f   f   f   f   f       ^t  <t      <t     <t      <t     <t  <t  <t  <t  f   f   f   f   f   f  f   f   f   f       ^t  <t      <t      <t      <t     <t  <t  <t  <t  f   f   f   f   f   f   f   f   f   f       ^t      <t     <t      <t     <t      <t  <t  <t  <t  f   f   f   f  f   f  f   f   f   f   ^t  <t   <t    <t      <t     <t         <t  <t  <t  f   f   f   f   f
f   f   f   f   f   f       f   f       ^t     f       f      f   f   f   f   f   f   f   f   f   f  f   f   f   f       f   f       ^t      f       f      f   f   f   f   f   f   f   f   f   f   f   f   f   f       f       f      ^t      f      f       f   f   f   f   f   f   f   f  f   f  f   f   f   f   f   f    ^t    f       f      f          f   f   f   f   f   f   f   f
f   f   f   f   f   f       f   f       f      f       f      f   f   f   f   f   f   f   f   f   f  f   f   f   f       f   f       f       f       f      f   f   f   f   f   f   f   f   f   f   f   f   f   f       f       f      f       f      f       f   f   f   f   f   f   f   f  f   f  f   f   f   f   f   f    f     f       f      f          f   f   f   f   f   f   f   f
f   f   f   f   f   f       f   f       f      f       f      f   f   f   f   f   f   f   f   f   f  f   f   f   f       f   f       f       f       f      f   f   f   f   f   f   f   f   f   f   f   f   f   f       f       f      f       f      f       f   f   f   f   f   f   f   f  f   f  f   f   f   f   f   f    f     f       f       f         f   f   f   f   f   f   f   f
f   f   f   f   f   f       f   >TPin5  f     vTPout4  f      f   f   f   f   f   f   f   f   f   f  f   f   f   f       >TPin6  f   f      vTPout5  f      f   f   f   f   f   f   f   f   f   f   f   f   f   f      >TPin15  f      f    vTPout14  f       f   f   f   f   f   f   f   f  f   f  f   f   f   f   >TPin16  f     f       vTPout15 f        f   f   f   f   f   f   f   f
f   f   >t  >t  >t  >S^    >t   >t     >t      >t      vt     f   f   f   f   f   f   f   f   f   f  >t  >t  >t  >S^    >t   >t     >t      >t   vt  f      f   f   f   f   f   f   f   f   f   >t  >t  >t  >S^ >t     >t      >t     >t       vt     f       f   f   f   f   f   f   f   f  f   >t >t >t >S^  >t   >t     >t     >t       vt      f         f   f   f   f   f   f   f   f
f   f   ^t  f   f   f       b   f       f       f      vP     f   f   f   f   f   f   f   f   f   f  ^t  f   f   f       b   f       f       f   vP  f      f   f   f   f   f   f   f   f   f   ^t  f   f   f   b       f       f      f       vP     f       f   f   f   f   f   f   f   f  f   ^t  f   f  f   b   f       f      f       vP      f         f   f   f   f   f   f   f   f
f   f   ^t  <Cui f  f       b   f       f       f      vt     f   f   f   f   f   f   f   f   f   f  ^t  <Cui f  f       b   f       f       f   vt  f      f   f   f   f   f   f   f   f   f   ^t  <Cui f  f   b       f       f      f       vt     f       f   f   f   f   f   f   f   f  f   ^t <Cui f  f   b   f       f      f       vt      f         f   f   f   f   f   f   f   f
f   f   ^t  f   f   f       b   f       f       f      vt     f   f   f   f   f   f   f   f   f   f  ^t  f   f   f       b   f       f       f   vt  f      f   f   f   f   f   f   f   f   f   ^t  f   f   f   b       f       f      f       vt     f       f   f   f   f   f   f   f   f  f   ^t  f   f  f   b   f       f      f       vt      f         f   f   f   f   f   f   f   f
f   f   ^t  f   f   f       b   f       f       f      vt     f   f   f   f   f   f   f   f   f   f  ^t  f   f   f       b   f       f       f   vt  f      f   f   f   f   f   f   f   f   f   ^t  f   f   f   b       f       f      f       vt     f       f   f   f   f   f   f   f   f  f   ^t  f   f  f   b   f       f      f       vt      f         f   f   f   f   f   f   f   f
f   f   ^t  f   f   f       b   f       f       f      vt     f   f   f   f   f   f   f   f   f   f  ^t  f   f   f       b   f       f       f   vt  f      f   f   f   f   f   f   f   f   f   ^t  f   f   f   b       f       f      f       vt     f       f   f   f   f   f   f   f   f  f   ^t  f   f  f   b   f       f      f       vt      f         f   f   f   f   f   f   f   f
f   f   ^t  f   f   f       b   f       f       f      vt     f   f   f   f   f   f   f   f   f   f  ^t  f   f   f       b   f       f       f   vt  f      f   f   f   f   f   f   f   f   f   ^t  f   f   f   b       f       f      f       vt     f       f   f   f   f   f   f   f   f  f   ^t  f   f  f   b   f       f      f       vt      f         f   f   f   f   f   f   f   f
f   f   ^t  f   f   f       b   f       f       >Ton    vt    f   f   f   f   f   f   f   f   f   f  ^t  f   f   f       b   f       f       >Ton vt f      f   f   f   f   f   f   f   f   f   ^t  f   f   f   b       f       f     >Ton     vt     f       f   f   f   f   f   f   f   f  f   ^t  f   f  f   b   f       f      >Ton     vt     f         f   f   f   f   f   f   f   f
f   f   ^P  f   f   f       b   f       >f       f     vt     f   f   f   f   f   f   f   f   f   f  ^P  f   f   f       b   f       >f       f  vt  f      f   f   f   f   f   f   f   f   f   ^P  f   f   f   b       f       >f      f      vt     f       f   f   f   f   f   f   f   f  f   ^P  f   f  f   b   f       >f      f      vt      f         f   f   f   f   f   f   f   f
f   f   ^t  <t  <t  <t      <t  <t      <t      <t     <t     f   f   f   f   f   f   f   f   f   f  ^t  <t  <t  <t      <t  <t      <t      <t  <t  f      f   f   f   f   f   f   f   f   f   ^t  <t  <t  <t  <t      <t      <t     <t      <t     f       f   f   f   f   f   f   f   f  f   ^t  <t  <t <t  <t  <t      <t     <t      <t      f         f   f   f   f   f   f   f   f
f   f   f   f   f   f       ^t  f       f       f      f      f   f   f   f   f   f   f   f   f   f  f   f   f   f       ^t  f       f       f   f   f      f   f   f   f   f   f   f   f   f   f   f   f   f   ^t      f       f      f       f      f       f   f   f   f   f   f   f   f  f   f   f   f  f   ^t  f       f      f       f       f         f   f   f   f   f   f   f   f
f   f   f   f   f   f       f   f       f       f      f      f   f   f   f   f   f   f   f   f   f  f   f   f   f        f   f       f      f       f      f   f   f   f   f   f   f   f   f   f   f   f   f   f       f       f       f      f      f       f   f   f   f   f   f   f   f  f   f   f   f  f   f   f       f       f       f       f        f   f   f   f   f   f   f   f
f   f   f   f   f   f       f   f       f       f      f      f   f   f   f   f   f   f   f   f   f  f   f   f   f        f   f       f      f       f      f   f   f   f   f   f   f   f   f   f   f   f   f   f       f       f       f      f      f       f   f   f   f   f   f   f   f  f   f   f   f  f   f   f       f       f       f       f        f   f   f   f   f   f   f   f
f   f   f   f   f   f       f   f       f       ^TPin7 vTPout6 f  f   f   f   f   f   f   f   f   f  f   f   f   f        f   f       f      ^TPin1 vTPout7 f   f   f   f   f   f   f   f   f   f   f   f   f   f       f       f       f     ^TPin17 vTPout16 f  f   f   f   f   f   f   f  f   f   f   f  f   f   f       f       f       ^TPin11 vTPout17 f   f   f   f   f   f   f   f
f   f   f   f   f   f       >t  >t      >t       >S^   >t     >t  >t  >t  vt  f   f   f   f   f   f  f   f   f   f        >t  >t      >t      >S^    >t     >t  >t  >t  vt  f   f   f   f   f   f   f   f   f   f       >t      >t      >t      >S^   >t     >t  >t  >t  vt   f   f   f   f  f   f   f   f  f   f   >t      >t      >t       >S^    >t       >t  >t  >t  vt  f   f   f   f
f   f   f   f   f   f       ^t  f       f       f      b      f   f   f   vP  f   f   f   f   f   f  f   f   f   f        ^t  f       f      f       b      f   f   f   vP  f   f   f   f   f   f   f   f   f   f       ^t      f       f       f      b      f   f   f   vP  f   f   f   f  f   f   f   f  f   f   ^t      f       f       f       b        f   f   f   vP  f   f   f   f
f   f   f   f   f   f       ^t  <Cui    f       f      b      f   f   f   vt  f   f   f   f   f   f  f   f   f   f        ^t  <Cui    f      f       b      f   f   f   vt  f   f   f   f   f   f   f   f   f   f       ^t      <Cui    f       f      b      f   f   f   vt  f   f   f   f  f   f   f   f  f   f   ^t      <Cui    f       f       b        f   f   f   vt  f   f   f   f
f   f   f   f   f   f       ^t  f       f       f      b      f   f   f   vt  f   f   f   f   f   f  f   f   f   f        ^t  f       f      f       b      f   f   f   vt  f   f   f   f   f   f   f   f   f   f       ^t      f       f       f      b      f   f   f   vt  f   f   f   f  f   f   f   f  f   f   ^t      f       f       f       b        f   f   f   vt  f   f   f   f
f   f   f   f   f   f       ^t  f       f       f      b      f   f   f   vt  f   f   f   f   f   f  f   f   f   f        ^t  f       f      f       b      f   f   f   vt  f   f   f   f   f   f   f   f   f   f       ^t      f       f       f      b      f   f   f   vt  f   f   f   f  f   f   f   f  f   f   ^t      f       f       f       b        f   f   f   vt  f   f   f   f
f   f   f   f   f   f       ^t  f       f       f      b      f   f   f   vt  f   f   f   f   f   f  f   f   f   f        ^t  f       f      f       b      f   f   f   vt  f   f   f   f   f   f   f   f   f   f       ^t      f       f       f      b      f   f   f   vt  f   f   f   f  f   f   f   f  f   f   ^t      f       f       f       b        f   f   f   vt  f   f   f   f
f   f   f   f   f   f       ^t  f       f       f      b      f   f   f   vt  f   f   f   f   f   f  f   f   f   f        ^t  f       f      f       b      f   f   f   vt  f   f   f   f   f   f   f   f   f   f       ^t      f       f       f      b      f   f   f   vt  f   f   f   f  f   f   f   f  f   f   ^t      f       f       f       b        f   f   f   vt  f   f   f   f
f   f   f   f   f   f       ^t  f       f       f      b      f   f   >Ton vt f   f   f   f   f   f  f   f   f   f        ^t  f       f      f       b      f   f   >Ton vt f   f   f   f   f   f   f   f   f   f       ^t      f       f       f      b      f   f   >Ton vt f   f   f   f  f   f   f   f  f   f   ^t      f       f       f       b        f   f   >Ton vt f   f   f   f
f   f   f   f   f   f       ^P  f       f       f      b      f   >f   f  vt  f   f   f   f   f   f  f   f   f   f        ^P  f       f      f       b      f   >f   f  vt  f   f   f   f   f   f   f   f   f   f       ^P      f       f       f      b      f   >f   f  vt  f   f   f   f  f   f   f   f  f   f   ^P      f       f       f       b        f   >f   f  vt  f   f   f   f
f   f   f   f   f   f       ^t  <t      <t      <t     <t     <t  <t  <t  <t  f   f   f   f   f   f  f   f   f   f        ^t  <t      <t     <t      <t     <t  <t  <t  <t  f   f   f   f   f   f   f   f   f   f       ^t      <t      <t      <t     <t     <t  <t  <t  <t  f   f   f   f  f   f   f   f  f   f   ^t      <t      <t      <t      <t       <t  <t  <t  <t  f   f   f   f
f   f   f   f   f   f       f   f       ^t      f      f      f   f   f   f   f   f   f   f   f   f  f   f   f   f        f   f       ^t     f       f      f   f   f   f   f   f   f   f   f   f   f   f   f   f       f       f       ^t      f      f      f   f   f   f   f   f   f   f  f   f   f   f  f   f   f       f       ^t      f       f        f   f   f   f   f   f   f   f
f   f   f   f   f   f       f   f       f       f      f      f   f   f   f   f   f   f   f   f   f  f   f   f   f        f   f       f      f       f      f   f   f   f   f   f   f   f   f   f   f   f   f   f       f       f       f       f      f      f   f   f   f   f   f   f   f  f   f   f   f  f   f   f       f       f       f       f        f   f   f   f   f   f   f   f
objectifs (LAINE;1) (VIANDE;1)
gevents 1
generator VIANDE spawntime=1 offset=0
entrees (6;12)
generator VIANDE spawntime=1 offset=0
entrees (8;26)
generator VIANDE spawntime=1 offset=0
entrees (6;40)
generator VIANDE spawntime=1 offset=0
entrees (8;54)
generator VIANDE spawntime=1 offset=0
entrees (25;12)
generator VIANDE spawntime=1 offset=0
entrees (27;26)
generator VIANDE spawntime=1 offset=0
entrees (25;40)
generator VIANDE spawntime=1 offset=0
entrees (27;54)
generator VIANDE spawntime=1 offset=0
entrees (44;12)
generator VIANDE spawntime=1 offset=0
entrees (46;26)
generator VIANDE spawntime=1 offset=0
entrees (44;40)
generator VIANDE spawntime=1 offset=0
entrees (46;54)
generator VIANDE spawntime=1 offset=0
entrees (63;12)
generator VIANDE spawntime=1 offset=0
entrees (65;26)
generator VIANDE spawntime=1 offset=0
entrees (63;40)
generator VIANDE spawntime=1 offset=0
entrees (65;54)
fin niveau



